21 21
#####################
....#.....#.....#...#
#.#.#.###.#####.#.#.#
#.#.#.#.......#.#.#.#
#.#.#.#.###.#.#.#.#.#
#.#...#..s#.#.#.#.#.#
#########.#.###.#.#.#
#.........#.....#.#.#
#.###############.#.#
#.......#...#.....#.#
#.#####.###.#######.#
#.#...#...#...#.....#
#.#.#.###.###.#.#.###
#.#.#...#.#...#.#.#.#
#.#.#####.#.###.#.#.#
#.#...#...#.#...#.#.#
#.###.#.#.#.#.###.#.#
#...#...#...#...#.#.#
###.#####.#####.#.#.#
#...#...........#...e
#####################
