10 10
##........
#..##.###.
##.##..###
##.###...e
##.#######
....#.##..
###.#.##.#
.##......#
....#.####
#####s####
